NO ./asset/texture/north.xpm
SO ./asset/texture/south.xpm
WE ./asset/texture/west.xpm
EA ./asset/texture/east.xpm

F 118,118,118
C 110,177,255

        1111111111110111111111111
        1000000000110000000000001
        1011000001110000000000001
        1001000000000000000000001
111111111011000001110000000000001
100000000011000001110111110111111
11110111111111011100000010001
11110111111111011101010010001
11000000110101011100000010001
10000000000000001100000010001
10000000000000001101010010001
1100000111010101111101 110N0111
11110111 1110101 10111 010001
11111111 1111111 11111 111111
