NO ./asset/texture/north.xpm
SO ./asset/texture/south.xpm
WE ./asset/texture/west.xpm
EA ./asset/texture/east.xpm

F 220,100,0
C 225,30,0

111111
10 0N1
1000 1
111111
