NO ./asset/textures/wolfenstein/grey_stone.xpm
SO ./asset/textures/wolfenstein/purple_stone.xpm
WE ./asset/textures/wolfenstein/red_brick.xpm
EA ./asset/textures/wolfenstein/wood.xpm

F 220,100,0
C 225,30,0

     11111111111111111111111111111111111111
         111001100001       111111101111111
         100001001111       100001000100001
         11100000111        100000000000001
           1110111          100001000100001
            1001            111101000100001
            1011           1110111000111111
            1111          11100000000100001
                         111110N01100000001
                        1111100001000100001
                            100011000111111
                            111110000000001
                           1100000000000001
                           1100000000000001
          11            1111110000000000001
          11            1111110000000000001
          11            1111110000000000001
          11            1111110000000000001
          11            1111110000000000001
          11            1111110000000000001
          11            1111110000000000001
          11            1111110000000000001
          11            1111110000000000001
          11            1111110000000000001
          11            1111110000000000001
          11            1111110000000000001
          11            1111110000000000001
          11            1111110000000000001
          11            1111110000000000001
          11            1111110000000000001
          11            1111110000000000001
          11            1111110000000000001
          11            1111110000000000001
          11            1111110000000000001
          11            1111110000000000001
          11            1111110000000000001
          11            1111110000000000001
          11            1111110000000000001
          11            1111110000000000001
          11            1111110000000000001
          11            1111110000000000001
          11            1111110000000000001
          11            1111110000000000001
          11            1111110000000000001
          11            1111110000000000001
          11            1111110000000000001
          11            1111110000000000001
          11            1111110000000000001
          11            1111110000000000001
          11            1111110000000000001
          11            1111110000000000001
          11            1111110000000000001
          11            1111110000000000001
          11            1111110000000000001
          11            1111110000000000001
          11            1111110000000000001
          11            1111110000000000001
          11            1111110000000000001
          11            1111110000000000001
          11            1111110000000000001
          11            1111110000000000001
          11            1111110000000000001
          11            1111110000000000001
          11            1111110000000000001
          11            1111110000000000001
          11            1111110000000000001
          11            1111110000000000001
1111111111111111111111111111111111111111111